.-....-.
.|....|.
.|....|.
.|....|.
.|....|.
.|....|.
.|....|.
.|....|.
.|....|.
.|....|.
.|....|.
._..@._.