.-....-.
.|....|.
.|....|.
.|....|.
._...._.
........
........
........
........
.-....-.
.|....|.
.|....|.
._...._.