.-....-.
.|....|.
.|....|.
.|....|.
.|....|.
.|....|.
.|....|.
.|....|.
.|....|.
.|....|.
.|....|.
._...._.