..|.......-.
..|>....._..
..|>.....-..
..|.........
..|.........
..|......._.