._.......|..
.........|..
.........|..
..-.....<|..
.._.....<|..
.-.......|..