.|......
.|......
.|......
.|......
.|....-.
.|....|.
.|....|.
.|...._.
.|......
.|......
.|......
.|......