............
.........-..
..-......|..
..|.....<|..
..|.....<_..
.._.........