.........-..
..->.....|..
..|>.....|..
..|......_..
.._.........
............